11060100000100000000
11000100010100000000
11101100000100000000
11101000000100000000
11000000000100001101
11000000001100001000
11000000000000001050
22000000022222222222
00000000000000000000
00000000000000000000
00000000000000000000
20222222222222220222
20000211111111110111
20000211111000000001
20000211111011100001
20000211111000100001
22222211111000100001
11111111111000101111
11111111111000100001
11111111111111111111
EOF
9#13,15:
9#13,17:
6#19,8:-1,0
6#19,9:-1,0
0#18,16:15,13-18,16-15,16-18,13
6#19,10:-1,0
6#15,6:0,-1
4#18,18:18,4
6#12,4:1,0
3#15,17:
5#8.5,5.5:2,2
9#11,17:
2#3,14:
4#19,0:11,14
9#12,18:
6#19,1:-1,0
6#19,2:-1,0
EOE