33333332222223333333
30003032600023000003
30003032000023333033
30003032220223330030
33033033330333330330
30004033000003030330
30000000011103000000
30000003011103333330
33333333011103000330
11111130000003000000
10000000033033000330
10001133330003333333
10001330000000000000
10001300000000001100
10001300011111111100
10001333010000000000
10001113333333333333
10001011111111111444
10000000000000000054
11111111111111111444
EOF
8#2,2:15,9
10#2,4:"Hm!?"~"What is this contraption?"~"Let's smash it!"~%2,2
9#19,15:
2#5,17:
4#10,15:17,2
9#6,13:
3#7,6:
9#6,14:
4#18,1:17,18
0#8,8:8,9-12,9-12,5-8,5
10#17,9:"Where am I?"~%17,9
9#14,1:
1#8,15:~8,12%0,1@2~8,15%0,-1@2
EOE