111111111111111
100011111111111
100011111110001
111011000000061
111011011110001
110000011111011
110111011111011
110100011110001
110000000000001
110100010110001
110111110111011
110000000100001
110100001100001
100000001000051
110111111111111
EOF
9#1,2:
4#9,13:3,4
9#2,1:
0#6,8:2,8-9,8
1#11,7:~11,7%1,0@5
2#1,13:
9#3,1:
4#11,9:2,12
5#2,13:1,1
4#7,13:10,8
3#12,10:
1#4,7:~4,7%1,0@6
9#1,1:
EOE