111111111111111
100000011111111
111111011111101
111100000001101
111100011100001
111000011101111
111111000001111
110000011101105
110111010101101
110111010101101
100011010101101
100011000000001
116111011101111
111111001000011
111111000000011
EOF
4#3,5:13,9
2#9,13:
4#13,2:13,8
9#8,8:
0#6,6:6,6-6,11-10,11-10,6
9#8,9:
3#8,10:
1#12,14:~12,14%0,-1@2~10,14%0,-1@2~6,14%0,-1@2
5#5.5,4.5:2,2
4#1,1:11,4
EOE