1111111111
1600000001
1000000001
1001010101
1000000001
1001010101
1000000001
1001010101
1000000051
1111111111
EOF
1#1,8:~1,6%0,-1@2}1,0@2~4,6%0,1@3}0,-1@3}1,0@3~8,6%0,-1@3}0,1@3}-1,0@3
EOE