1111111111
1100000011
1100000011
1100000011
1500000061
1100000011
1100000011
1100000011
1111111111
1111111111
EOF
1#4,2:~4,2%0,1@5
5#4,3:1,1
6#4,7:0,-1
EOE