0006000000
2200222022
0100122022
5000122022
1110120002
1110100001
1000001111
1100001001
1110000001
1111001001
EOF
3#3,5:
2#8,8:
5#2,2:2,2
5#6,8:1,1
EOE