1111601111
1222002001
1002002001
1002000001
1000002001
1002002221
1222000001
1000002001
1502002001
1111111111
EOF
3#3,4:
4#1,4:3,7
4#8,3:6,6
2#8,7:
EOE