2222222222
2020220002
2520020002
2000220202
2222220202
2222220202
2020020202
2600020002
2020020002
2222222222
EOF
8#7,8:4,7
8#4,3:7,1
5#2,2:1,1
0#7,7:6,7-6,2-8,2-8,7
EOE