11111111116111111111
11111111000000111111
11111100000000001111
11111111000000111111
11111111101101111111
11111111101100040011
33333333101100044011
33333333101100004011
33333333101111000011
33330000001111100111
33330003111111101111
33330503111000000011
33330003111044440011
33333333111000040011
33333333111044440011
33333333111040000011
33333333111044440011
33333333111000000011
33333333111110001111
33333333111111011111
EOF
0#14,8:17,8-14,8
0#13,15:16,15-13,15
0#6,2:15,2-6,2
2#9,5:
1#16,5:
1#14,19:
2#9,7:
0#11,11:11,17-17,17-17,11-11,11
EOE