33333331160111111000
30000031100111111000
30000030000001111110
30000030000000000010
30000030222201100110
33303330222201100000
30000030000001100101
30000033333331110100
30000000000030000100
33333033333030500100
33333033333030000100
33333033333033333301
30000000000000000001
30333000333033300301
30333000333333300301
30333000333333300311
30333000333333300311
30333000333333300311
30000000000000000311
33333333333333333311
EOF
6#17,3:-10,0
9#16,10:
6#18,14:0,-1
1#7,18:~15,18%0,-1@5~1,18%0,-1@5}1,0@5~1,12%0,1@5}1,0@2~6,12%1,0@2}-1,0@5}0,1@5~6,18%0,-1@5}-1,0@5}1,0@5
9#13,8:
1#9,6:~7,6%0,-1@5~12,6%0,-1@5
9#13,10:
3#16,7:
4#3,2:19,4
2#17,1:
5#11,11:
EOE