11111114444444440444
11111114000000400004
11444444040000400004
11406044040000400000
11400044040044400000
11400044444044440404
11440441144000000404
11140411144444444404
11140411145000000404
14440444444444444404
14000000040000000404
14044404040000000404
14040404040000000404
14040404040000000404
14040444040000000404
14000000040000000404
14404000040000000404
14004000044444444404
14004000000000000004
14444444444444444444
EOF
5#16,3:2,2
2#8,4:
0#2,15:2,15-8,15
8#2,18:13,16
4#16,0:9,1
0#5,16:8,16-5,16
8#13,10:16,8
3#3,16:
0#2,10:8,10-2,10
EOE