000444444422222
044444444420002
044444444420002
044400000000002
000004444422222
000004000444444
440444000000004
000444000000404
440424444440004
440424000000004
000444444044004
110114333044004
100014300000004
106014333034004
111114443534444
EOF
3#11,12:
6#0,10:1,0
5#9.0,11.0:1,1
6#7,12:1,0
2#2,0:
0#0,5:0,5-4,5-4,4-0,4
0#11,9:11,9-11,6
8#12,2:7,6
6#0,7:1,0
EOE