1111111111111111111111111
1000001111111111000000001
1000001111111111011111101
1000001111111111000010001
1000000000000000000010601
1000001111110111110010001
1000001100000111110011111
1000001101111111110011111
1111111101111111330033311
1111111111113333300000311
1144444444113000003330311
1140000004113033333330311
1140000004113000000000311
1140000004113000000000001
1140444444113000000000101
1140411111133031111111101
1140411111330031111010001
3330313303300033311010001
3030313000000000311000001
3030333000300000000000001
5000000000300000000000001
3030333000300000000000001
3030313000333333311000001
3333313333311111111000001
1111111111111111111111111
EOF
2#8,17:
0#1,7:1,7-5,7-5,4-1,4
6#23,19:-1,0
6#23,20:-1,0
2#19,16:
5#15.0,13.0:1,3
6#23,21:-1,0
9#23,23:
3#10,18:
4#3,5:20,9
7#1,20:
2#19,23:
6#1,22:0,-1
4#7,13:1,21
9#8,8:
0#5,1:5,4-1,4-1,1-5,1
3#13,11:
1#7,22:~7,22%1,0@3z0,-1@3
EOE